111111111111111111111111111111
1P01C10100101C10101010101000C1
101001001000001000000000001011
100100100011100011111011101001
1010010011100000111C0011101011
101010011100000010001100001001
1010011C00000B0000110001001011
101001111111100111C001110010C1
101000000001100111011111001011
101010111001100000000000001001
1000100C1000001011010101001011
1C11111110010001C00001011C00E1
111111111111111111111111111111