111111111111111111111111111111
1CE111C0000001C000010001000001
1001C1111110111010110101000001
100101000000001010000101111101
10010101111000C010111101000101
10010101C111111111111101010101
100100010000000000000100010101
100001010111011101101111110111
11110101010010001C100010010001
1C0001C100000010001C1000010001
1011111101111111111111111101C1
10100C010001010001P00001000011
1000111C01000001000101000110C1
111111111111111111111111111111